
alteniquia = {
	#Anòshphéy
	1 2 3 4 5 6 7 8 9 10 11 12 13 14 15 16 17 18 19 20 21 22 23 24 25 26 27 28 29 30 31 32 33 34 35 36 37 38 767 39 40 41 42 43 44 45 46 52 53 54 55 56 57
	#Audal
	58 59 60 61 62 63 64 65 66 67 68 69 70 71 97 98 99 100 101 102 103 104 105 106 107 108 109 110 111 112 113 114 115 116 117 118 119 120 121 122 123 124 125 126 127 128 129 130 131 132 133 134 135 136 137 138 139 140 141 142 143 144 145 146 151 147 148 149 150
	#Azuria
	72 73 74 75 76 77 78 79 80 81 82 83 84 85 86 87 88 89 90 91 92 93
	#Theiónikos
	152 153 154 155 156 157 166 158 159 160 161 162 163 164 165 167 168 169 170 171 172 173 174 175 176 177 178 179 180 181 182 183 184 185 186 187 188 189 190 191 192 193 194 195 196 197 198 199 200 201 202 203 204 205 206 207 208 209
	#Raell
	210 211 212 213 214 748 749 215 216 217 218 219 235 220 221 222 223 224 225 226 227 228 229 230 231 232 760 233 234 236 237 238 261 262 753 754 755
	#Sironia
	239 240 241 242 243 243 244 245 246 247 248 249 250 251 252 759 255 256 253 254 322 323
	#Lapidosa
	257 258 259 260 299 300 301 316 304 305 306 307 308 309 310 311 321 756 757 758 312 313 314 315 317 318 319 320 302 303
	#Beyond-the-Marshes
	263 264 265 266 267 761 765 268 269 764 270 271 272 762 273 763 281 282 283 284 285 286 287 288 289 274 275 276 277 278 279 280
	#Tálor
	292 293 294 94 95 96 290 291 295 296 297 298 750
	#Inner Vastallos
	324 325 329 330 326 327 328 331 332 333 334 335 336 337 359 360 361 362 363 364 365 745 746 747 1292
	#Outer Vastallos
	338 339 340 341 342 343 344 345 346 347 348 349 350 351 352 353 355 356 354 357 358 366 367 368 369 370 371
	#Arm Of Vastallos
	372 373 374 375 376 377 378 379 751 380 381 382 383 384 385 386 387

	#Wastelands
	1132 1133 1134 1135 1136 1137 1138 1139 1140 1141 1142 1143 1144 1145 1146 1147 1148 1149 1150 1151 1152 1153 1154

	#Lakes
	1173 1174 1175 1176 1177 1198
}

nieden = {
	#Egalia
	388 389 390 391 392 393 394 395 396 397 398 399 400 401 402 403 404 422 423 424 425 426 427 428 429 430 431 432 433 434 435 436 437 438 439 440 441 442 443 444 445 446 447 452 453 448 449 450 451 473 474 475 476 477 478 479
	#Argentor
	460 461 462 463 464 465 466 467 468 469 470 471 472 493 494 495 496 497 498 499 500 501 502 503 504 505 506 507 508 509 510 511 512 513 514 515 516 517 518 519 520 521 522 523 524 525 526 527 528 529 530 531 532 533 534 535 536 537 538 539 540 541 542 543 544 545 546 547 548 553 554 555 556 557 558 559 560 561 562 563 564 565
	#Raykara
	405 406 407 408 409 410 411 412 413 414 415 416 417 418 419 420 421 752 454 455 456 457 458 459
	#Khuzdurin
	47 48 49 50 51 766 480 481 482 483 484 485 486 487 488 489 490 491 492 549 550 551 552
	#Escharia
	566 567 568 569 570 571 572 573 574 575 576 577 578 579 580 581 582 583 584 585 586 587 588 589 590 591 592 593 594 595 596 597 598 599 600 601 602 603 604 605 606 607 608 609 610 611 612 613
	#Suderen
	614 615 616 617 618 619 620 621 622 623 624 625 626 627 628 629 630 631 632 633 634 635 636 637 638 639 640 641 642 643 644 645 646 647 648 649 650

	#Wastelands
	1155 1156 1157 1158 1159 1168 1169 1170 1171

	#Lakes
	1178 1179 1180 1181 1182 1183 1184 1185 1186 1187 1188 1189 1190 1191 1218 1219 1290
}

sparwood = {
	#Vraelea
	651 652 653 654 655 656 657 658 660 659 661 662 663 664
	#Hithray
	665 669 670 674 675 666 667 668 671 672 673 676 677 678 679 680 681 682
	#Kietres
	683 684 685 686 687 688 689 690 691 692 693 694 695 696 697 698 699 705 700 701 702
	#High Luthéa
	703 704 706 707 708 709 710 711 712 713 714 715 716 717 721 722 718 719 720 732 733 741 742 723 724 725 726 727 728 729 730 731 734 735 736 737 738 739 740 743 744

	#Wastelands
	1160 1161 1162 1163 1164 1165 1166 1167 1172

	#Lakes
	1192 1193 1194 1195 1196 1197 1199 1200 1201 1202 1203 1204 1205 1206 1207 1208 1209 1210 1211 1212 1213 1214 1215 1216 1217

	#Unreleased
	4977 #Akratia
	4978 #Frozen Wastes
}

syltor = {
	#Lakes
	9570 9571 9572 9573 9574 9575 9576 9577 9578 9579 9580 9581 9582 9583 9618
	1243 1244 1245 1246 1247 1248 1249 1250 1251 1252 1253 1254 1255 1256 1291

	#Unreleased
	4982 #Sýltör
}

ummarnu = {
	#Lakes
	1240 1241 1242

	#Unreleased
	4983 #Ummarnu
}

the_north = {
	#Lakes
	1257 1258 1259 1260 1261 1262 1263 1264 1265 1266 1267 1268

	#Unreleased
	4979 #Wandering Deserts

}

sorligste = {
	#Lakes
	1220 1221 1222 1223

	#Unreleased
	4985 #Sørligste
}

haven = {
	#Lakes
	1230 1231 1232 1233 1234 1235 1236 1237 1238 1239

	#Unreleased
	4984 #Haven
}

valdreach = {
	#Lakes
	1224 1225 1226 1227 1228 1229

	#Unreleased
	4986 #Valdreach
}

plagos = {
	#Unreleased
	4980 #Plagos
	4980 #Skjoldrbróðir
}

akannash = {
	#Lakes
	9596 9597 9598 9599 9600 9601 9602 9603 9604 9605 9606 9607 9608 9609 9610 9611 9612 9613 9614 9615 9616
	1269 1270 1271 1272 1273 1274 1275 1276 1277 1278 1279 1280 1281 1282 1283 1284 1285 1286 1287 1288 1289

	#Unreleased
	4987 #Southern Akan'nash
	4988 #Northern Akan'nash
}

unreleased_seas = {
	4989 #Far Endless Sea
	4990 #Endless Sea
	4991 #Domeri Sea
	4992 #Gulf of Heaven
	4993 #Barbaric Sea
	4994 #Heart of Haven
	4995 #Jehkesunn
	4996 #Nekkic Sea
	4997 #Svalden Sea
	4998 #Osterium Sea
	4999 #Shattered Sea
}

### Base Game

europe = {

}

asia = {

}

africa = {

}

north_america = {

}

south_america = {

}

oceania = {

}

debug_continent = { #unused province ids go here to prevent errors. if an id is present in 2 continents, it will create an error, so they're easy to find

}

island_check_provinces = {
}

# Used for RNW
new_world = {
}