
#Example: Large parts of Africa and south east Asia
tropical = {
	179 180 326 327 328 329 330 331 332 333 334 335 336 337
	338 339 352 353 354 355 356 357 358 359 360 361 362 363
	364 365 366 367 368 369 370 371 372 373 374 375 376 377 
	378 379 380 381 382 745 751 1292 1333 1334 1335 1336 1337 
	1338 1339 1340 1341 1342 1343 1344 1345 1346 1347 1348 1349 
	1350 1351 1352 1353 1354 1355 1356 1357 1358 1359 1360 1361 
	1362 1363 1364 1365 1366 1367 1368 1369 1370 1371 1372 1373 
	1374 1375 1376 1377 
}
arid = {
	1 2 3 4 8 9 10 11 12 13 14 15 16 17 18 19 20 21 22 23 24 25 
	26 27 28 29 59 60 61 62 63 64 65 66 67 68 69 70 71 72 73 74 
	75 76 113 114 115 121 122 123 125 126 127 128 129 130 131 132 
	133 139 140 141 142 143 144 145 146 147 148 149 150 151 152 153 
	154 155 156 157 158 159 160 161 162 163 164 165 166 167 168 169 
	170 171 172 173 174 175 176 177 178 184 185 186 187 188 189 190 
	191 192 193 194 195 196 197 198 199 200 201 202 203 204 1293 1294 
	1295 
}
arctic = {
	651 652 653 654 655 656 657 658 659 660 661 662 663 
}

#Example: Most of Europe north of med.
mild_winter = {

}

#Example: Inland Europe & Scandinavia
normal_winter = {

}

#Example: Russia & Lappland
severe_winter = {

}

impassable = {
	#Alteniquia
	1132 1133 1134 1135 1136 1137 1138 1139 1140 1141 1142 1143 1144 1145 1146 1147 1148 1149 1150 1151 1152 1153 1154 1297

	#Nieden
	1155 1156 1157 1158 1159 1168 1169 1170 1171

	#Sparwood
	1160 1161 1162 1163 1164 1165 1166 1167 1172 1429 1468 1469 1470 1471 1585 1586
	1665 1666 1667 1668 1669 1670 1671 1672 1673 1674

	#Unreleased Sea
	4989 4990 4991 4992 4993 4994 4995 4996 4997 4998 4999

	#Cymru
	2014 2015 2016 2017 2018 2019 2020 2021 2022 2023 2024 2025 
	2026 2027 2028 2029 2030 2031 2032 2033 2034 2035 2036 2037 
	2038 2039 2040 2041 2042 2043 2044 2045

	#Unreleased Land
	4977 #Akratia
	4978 #Frozen Wastes
	4982 #Syltor
	4983 #Ummarnu
	4979 #Wandering Deserts
	4985 #Sorligste
	4984 #Haven
	4986 #Valdreach
	4980 #Plagos
	4981 #Skjoldrbrodir
	4987 #Southern Akan'nash
	4988 #Northern Akan'nash
}

mild_monsoon = {

}

normal_monsoon = {

}

severe_monsoon = {

}

equator_y_on_province_image = 656 #what
