
#Example: Large parts of Africa and south east Asia
tropical = {
	179 180 326 327 328 329 330 331 332 333 334 335 336 337
	338 339 352 353 354 355 356 357 358 359 360 361 362 363
	364 365 366 367 368 369 370 371 372 373 374 375 376 377 
	378 379 380 381 382 745 751 1292 1333 1334 1335 1336 1337 
	1338 1339 1340 1341 1342 1343 1344 1345 1346 1347 1348 1349 
	1350 1351 1352 1353 1354 1355 1356 1357 1358 1359 1360 1361 
	1362 1363 1364 1365 1366 1367 1368 1369 1370 1371 1372 1373 
	1374 1375 1376 1377 
}
arid = {
	1 2 3 4 8 9 10 11 12 13 14 15 16 17 18 19 20 21 22 23 24 25 
	26 27 28 29 59 60 61 62 63 64 65 66 67 68 69 70 71 72 73 74 
	75 76 113 114 115 121 122 123 125 126 127 128 129 130 131 132 
	133 139 140 141 142 143 144 145 146 147 148 149 150 151 152 153 
	154 155 156 157 158 159 160 161 162 163 164 165 166 167 168 169 
	170 171 172 173 174 175 176 177 178 184 185 186 187 188 189 190 
	191 192 193 194 195 196 197 198 199 200 201 202 203 204 1293 1294 
	1295 
}
arctic = {
	651 652 653 654 655 656 657 658 659 660 661 662 663 
}

#Example: Most of Europe north of med.
mild_winter = {
	33 34 49 106 107 108 109 110 113 115 183 234 236 237 238 247 248 266 268 281 282 
	283 285 310 311 321 394 395 396 397 398 399 400 401 402 403 404 405 406 407 408 
	409 410 411 412 413 414 415 418 422 423 424 425 426 427 428 429 430 431 432 433 
	434 440 441 442 443 444 445 446 447 448 449 450 451 452 453 454 455 460 461 462 
	463 465 466 467 473 476 478 480 481 482 486 487 488 491 492 510 511 512 513 514 
	515 516 517 518 519 520 521 522 523 524 526 527 528 529 530 531 532 533 534 538 
	542 544 559 561 562 563 564 565 566 567 568 569 570 571 572 573 574 575 576 577 
	578 579 580 581 582 583 584 588 589 590 592 594 596 601 602 603 604 605 606 607 
	608 609 610 611 612 615 616 619 621 622 623 624 625 627 629 630 631 632 633 643 
	644 646 671 672 673 674 675 676 677 678 679 680 681 682 686 687 688 689 691 702 
	703 705 706 707 708 713 716 717 718 719 720 721 722 723 724 725 726 727 730 731 
	732 733 734 735 736 737 738 739 744 759 764 765 1305 1319
}

#Example: Inland Europe & Scandinavia
normal_winter = {
 50 284 464 468 469 470 471 472 474 475 477 479 483 484 489 490 493 494
 495 497 498 499 500 501 502 503 504 505 506 507 508 509 535 536 537 539
 540 541 543 595 597 598 599 600 613 614 620 634 635 636 637 638 639 640
 641 642 645 647 648 649 650 654 655 656 658 662 663 664 665 666 667 668
 669 670 683 685 690 704 728 729 740 741 1323 1324 1326
}

#Example: Russia & Lappland
severe_winter = {
	31 32 485 496 651 652 653 657 659 660 661 684
}

impassable = {
	#Alteniquia
	1132 1133 1134 1135 1136 1137 1138 1139 1140 1141 1142 1143 1144 1145 1146 1147 1148 1149 1150 1151 1152 1153 1154 1297

	#Nieden
	1155 1156 1157 1158 1159 1168 1169 1170 1171

	#Sparwood
	1160 1161 1162 1163 1164 1165 1166 1167 1172 1429 1468 1469 1470 1471 1585 1586
	1665 1666 1667 1668 1669 1670 1671 1672 1673 1674 2336 2337

	#Unreleased Sea
	4989 4990 4991 4992 4993 4994 4995 4996 4997 4998 4999

	#Cymru
	2014 2015 2016 2017 2018 2019 2020 2021 2022 2023 2024 2025 
	2026 2027 2028 2029 2030 2031 2032 2033 2034 2035 2036 2037 
	2038 2039 2040 2041 2042 2043 2044 2045

	#Ummarnu
	2070 2071 2224 2207 2208 2209 2210 2206

	#Unreleased Land
	4977 #Akratia
	4978 #Frozen Wastes
	4982 #Syltor
	4983 #Ummarnu
	4979 #Wandering Deserts
	4985 #Sorligste
	4984 #Haven
	4986 #Valdreach
	4980 #Plagos
	4981 #Skjoldrbrodir
	4987 #Southern Akan'nash
	4988 #Northern Akan'nash
}

mild_monsoon = {

}

normal_monsoon = {

}

severe_monsoon = {

}

equator_y_on_province_image = 656 #what
