width = 5632
height = 2048

max_provinces = 5000
sea_starts = {
	#Sea of Pearls
	768 769 770 771 1122 1131 772 773 774 775 776 777 778 779 780 781 782 783 1118 1119 1120 1121 1125 1126

	#Astyllean Sea
	784 785 786 787 788 789 790 791 795 802 803 804 805 806 792 793 794 796 797 798 799 800 801 807 1327

	#Western Rough Sea
	808 809 810 811 816 817 812 813 814 815 818 1303
	
	#Eastern Rough Sea
	819 820 821 822 1128 823 824 825 826 838 839 827 828 829 832 830 831 835 836 833 834 837 1129 840 841 842 843

	#Cursed Sea
	844 845 846 847 855 856 848 849 850 851 852 853 854 857 858 859 860 861 862 863 864 865 866 867 868 

	#Eversummer Sea
	869 870 871 872 873 874 875 876 877 878 879
	
	#Keshite Sea
	880 881 885 882 883 884 886 887 888 889 890 891 909 892 893 894 895 896 897 898 899 900 901 902 903 904 905 906 907 908

	#Sea of Slaves
	910 931 933 935 929 932 934 936 937 911 912 913 914 915 916 930
	
	#Ombrian Gulf
	917 918 919 920 921 928 1130 922 923 924 925 926 927
	
	#Western Phagosian Sea
	938 972 973 939 940 941 942 964 965 966 982 967 980 981 968 969 970 971 974 975 976 977 978 979 1328
	
	#Eastern Phagosian Sea
	943 944 945 946 961 962 963 948 949 950 998 999 947 951 952 953 954 955 956 957 958 959 960

	#Sea of Galleons
	983 984 993 994 995 996 997 985 986 987 988 989 990 991 992
	
	#Sea of Andorn
	1000 1001 1002 1003 1004 1005 1006 1007 1008
	
	#Sea of Petals
	1009 1010 1011 1012 1013 1014 1015 1016 1017 1024 1018 1019 1020 1021 1022 1023
	
	#Sea of Bern
	1025 1026 1027 1028 1029 1030 1031 1123 1124 1127
	
	#The Duskwaters
	1032 1033 1034 1035 1036 1037 1061 1062
	
	#Atardon Sea
	1038 1039 1040 1041 1044 1045 1048 1049 1042 1043 1046 1047 1050 1051 1052 1053 1054
	
	#Silver Sea
	1055 1056 1057 1058 1059 1060 1063 1064 1065 1066 1067 1068 1069 1070 1071 1072 1073 1074 1085 1075 1076 1077 1078 1079 1080 1081 1082 1083 1084 1086 1087

	#Osterium Sea
	1088 1089 1090 1091 1092 1093 1094 1095 1096 1097 1113 1114 1098 1099 1109 1110 1115 1116 1117 1100 1101 1102 1103 1104 1105 1106 1107 1108 1111 1112

	#Cymru Seas lol idk
	1675 1676 1677 1678 1679 1680 1681 1682 1683 1684 1685
	1686 1687 1688 1689 1690 1691 1692 1693 1694 1695 1696
	1697 1698 1699 1700 1701 1702 1703 1704 1705 1706 1707 
	1708 1709 1710 1711 1712 1713 1714 1715 1716 1717 1718
	1719 1720 1721 1722 1723 1724 1725 1726 1727 1728 1729
	1730 1731 1732 2046

}

only_used_for_random = { }

lakes = {
	1173 1174 1175 1176 1177 1178 1179 1180 1181 1182 1183 1184 1185 1186 1187 1188 1189 1190 1191 1192 
	1193 1194 1195 1196 1197 1198 1199 1200 1201 1202 1203 1204 1205 1206 1207 1208 1209 1210 1211 1212 
	1213 1214 1215 1216 1217 1218 1219 1220 1221 1222 1223 1224 1225 1226 1227 1228 1229 1230 1231 1232 
	1233 1234 1235 1236 1237 1238 1239 1240 1241 1242 1243 1244 1245 1246 1247 1248 1249 1250 1251 1252 
	1253 1254 1255 1256 1257 1258 1259 1260 1261 1262 1263 1264 1265 1266 1267 1268 1269 1270 1271 1272 
	1273 1274 1275 1276 1277 1278 1279 1280 1281 1282 1283 1284 1285 1286 1287 1288 1289 1290 1291 1329
	1330 1331 1332 1466 1467 

	#Cymru
	2003 2004 2005 2006 2007 2008 2009 2010 2011 2012 2013

	#Temporary (Undeveloped Seas)
	4989 #Far Endless Sea
	4990 #Endless Sea
	4991 #Domeri Sea
	4992 #Gulf of Heaven
	4993 #Barbaric Sea
	4994 #Heart of Haven
	4995 #Jehkesunn
	4996 #Nekkic Sea
	4997 #Svalden Sea
	4998 #Osterium Sea
	4999 #Shattered Sea
	
	#RNW Lake provinces	
}

force_coastal = { 
	807 808 809 810 811 812 813 814 816 817 818 819 820 
	821 822 823 824 825 827 828 829 830 831 832 833 834 
	836 838 839 840 841 842 843 844 845 846 847 848 849 
	851 854 855 857 858 859 860 880 882 885 886 887 888 
	890 891 905 906 907 910 911 912 915 916 929 933 935 
	936 937 938 939 940 941 942 943 944 945 947 948 949 
	950 953 954 955 960 961 962 963 966 967 968 971 977 
	978 979 980 981 983 985 986 993 995 998 999 1088 1089 
	1090 1092 1093 1094 1095 1096 1097 1098 1107 1108 1110 
	1111 1113 1115 1128 1129 1130 1131 1303
}

definitions = "definition.csv"
provinces = "provinces.bmp"
positions = "positions.txt"
terrain = "terrain.bmp"
rivers = "rivers.bmp"
terrain_definition = "terrain.txt"
heightmap = "heightmap.bmp"
tree_definition = "trees.bmp"
continent = "continent.txt"
adjacencies = "adjacencies.csv"
climate = "climate.txt"
region = "region.txt"
superregion = "superregion.txt"
area = "area.txt"
provincegroup = "provincegroup.txt"
ambient_object = "ambient_object.txt"
seasons = "seasons.txt"
trade_winds = "trade_winds.txt"
canal_definition = {
	name = "athazolant_canal"
	x = 3840
	y = 625
}



# Define which indices in trees.bmp palette which should count as trees for automatic terrain assignment
tree = { 3 4 7 10 }
